
                               @   @    @              @          @  
                   @            @  @@   @@             @@   @@@@@@@@ 
      @@@@@@@@@@@@@@@           @@  @   @@@@@           @@       @@  
           @@ @@                @ @@@@@@@               @        @@  
           @@ @@                    @@ @   @             @       @@  
       @   @@ @@   @          @   @ @   @@@@@         @@@@@      @@  
       @@@@@@@@@@@@@@          @@ @ @ @   @@            @@  @@@@@@@  
       @@  @@ @@  @@           @ @ @@@@@ @@             @@  @@   @   
       @@  @@ @@  @@             @ @ @@  @              @@  @@       
       @@  @@ @@@@@@            @  @ @@  @@             @@  @@       
       @@ @@   @@@@@          @@@  @ @@@@@@@@           @@  @@       
       @@@        @@           @@  @ @@  @@             @@ @@@       
       @@         @@           @@ @@ @@  @@             @@@ @@     @ 
       @@@@@@@@@@@@@           @@ @  @@  @@            @@@  @@     @ 
       @@         @@           @@ @ @@@ @@@             @   @@@@@@@@@
       @          @            @ @   @   @                   @@@@@@@ 

